21x21
+-+-+-+-+-+-+-+-+-+-+
B |   | |     |     |
+ + + + + +-+ + +-+ +
|   |     | | |   | |
+-+-+-+-+ + + +-+ + +
|     |   | |   | | |
+ +-+ +-+ + + + + + +
| | |     |   |   | |
+ + + +-+-+-+-+ +-+ +
| | |     |   | |   |
+ + +-+-+ + +-+ + +-+
|   |   |   |   | | |
+-+-+ + + +-+-+ + + +
|     |     |   |   |
+-+-+ +-+ +-+-+ +-+-+
|     |       |   | |
+ +-+-+-+-+-+-+-+ + +
|         |     |   |
+-+-+-+-+ + +-+-+ +-+
|         |         E
+-+-+-+-+-+-+-+-+-+-+